ABILIFY
ACETAMINOPHEN WITH CODEINE - Tylenol with codeine
ACTONEL
ADVAIR DISKUS
ALBUTEROL 0.083% INHAL SOLN - Proventil
ALENDRONATE - Fosamax
ALLOPURINOL - Zyloprim
ALPRAZOLAM - Xanax
AMLODIPINE - Norvasc
AMOX TR-K CLV - Augmentin
AMOXICILLIN - Amoxil
AMOXICILLIN SUSP - Amoxil
AMPHETAMINE MIX SALT XR - Adderall xr
ATENOLOL - Tenormin
ATORVASTATIN - Lipitor
AVAPRO
AVELOX
AZITHROMYCIN - Zithromycin
AZITHROMYCIN SUSP - Zithromycin
BENICAR
BONIVA
BUPROPION SR - Wellbutrin sr
CARVEDILOL - Coreg
CELEBREX
CEPHALEXIN - Keflex
CHANTIX
CIALIS
CIPROFLOXACIN - Cipro
CITALOPRAM - Celexa
CLONAZEPAM - Klonopin
CLONIDINE - Catapres
CLOPIDOGREL - Plavix
CLOTRIMAZOLE/BETAM CREAM - Lotrisone
COMBIVENT INHALER
CRESTOR
CYCLOBENZAPRINE - Flexeril
CYMBALTA
DIGOXIN - Lanoxin
DIOVAN
DIVALPROEX EC TAB - Depakote
DONEPEZIL - Aricept
DOXYCYCLINE - Vibramycin
ENALAPRIL - Vasotec
ESCITALOPRAM - Lexapro
EVISTA
FEXOFENADINE - Allegra
FINASTERIDE - Proscar
FLOVENT HFA INHALER
FLUCONAZOLE - Diflucan
FLUOXETINE - Prozac
FLUTICASONE NASAL - Flonase
FOLIC ACID
FUROSEMIDE - Lasix
GABAPENTIN - Neurotin
GLIMEPIRIDE - Amaryl
GLIPIZIDE ER - Glucotrol xl
HUMALOG MIX
HYDROCHLOROTHIAZIDE - Hydrodiuril
HYDROCODONE / ACETAMINOPHEN - Vicodin
HYDROCORTISONE 2.5% CREAM - Hytone
IBUPROFEN - Motrin
JANUVIA
LAMOTRIGINE - Lamictal
LANSOPRAZOLE - Prevacid
LANTUS SOLOSTAR
LATANOPROST 0.005% DROPS - Xalatan
LEVOTHYROXINE - Synthroid
LISINOPRIL - Zestril
LISINOPRIL/HCTZ - Zestoretic
LOESTRIN
LOSARTAN - Cozaar
LOVAZA CAP
LYRICA
MELOXICAM - Mobic
METFORMIN ER - Glucophage xr
METFORMIN HCL - Glucophage
METOPROLOL XL - Toprol xl
METOPROLOL - Lopressor
METRONIDAZOLE - Flagyl
MONTELUKAST SOD - Singulair
MUPIROCIN OINTMENT - Bactroban
NABUMETONE - Relafen
NAMENDA
NAPROXEN - Naprosyn
NASONEX INHALER
NEXIUM
NIFEDIPINE ER - Procardia xl
NITROFURANTOIN MONO - Macrobid
NOVOLOG MIX FLEXPEN SYRN
OLANZAPINE - Zyprexa
OMEPRAZOLE - Prilosec
ORTHO TRI CYCLEN LO
OXYCODONE / ACETAMINOPHEN - Percocet
PANTOPRAZOLE - Protonix
PAROXETINE - Paxil
PENICILLIN -VK
PHENYTOIN SOD EXT - Dilantin
PIOGLITAZONE - Actos
POTASSIUM - K-dur
PRAVASTATIN - Pravachol
PREDNISONE
PREDNISONE
PREMARIN
PROVENTIL HFA INHALER
QUETIAPINE - Seroquel
QUINAPRIL - Accupril
RAMIPRIL - Altace
RANITIDINE - Zantac
RISPERIDONE - Risperdal
SERTRALINE - Zoloft
SIMVASTATIN - Zocor
SPIRIVA HANDIHALER
STRATTERA
SULFAMETH/TRIMETH DS - Bactrim ds
SUMATRIPTAN - Imitrex
SYNTHROID
TAMSULOSIN - Flomax
TERBINAFINE - Lamisil
TERCONAZOLE 0.8% VAGINAL CREAM - Terazol
TOPIRAMATE - Topamax
TRAMADOL - Ultram
TRAZODONE - Desyrel
TRI-SPRINTEC TAB - Ortho tri-cyclen
TRIAMTERENE / HCTZ - Maxzide
TRICOR
TRUVADA
VALACYCLOVIR - Valtrex
VENLAFAXINE XR - Effexor xr
VENTOLIN HFA INHALER
VIAGRA
VITAMIN D
VYTORIN
WARFARIN - Coumadin
YAZ
ZETIA
ZOLPIDEM - Ambien
ZOLPIDEM - Ambien cr